NO ./path_to_the_north_texture
SO ./path_to_the_south_texture
WE ./path_to_the_west_texture
EA ./path_to_the_east_texture

F 235,135,206
C 225,30,0

1111111111111
1000000000001
100100W000001
1010000000001
100001D100001
1000000000001
1111111111111